1111111111111111111111
110000VC10C1C0CC1011E1
10000000C0001101111001
1C00000110C0V000000001
1C00000000P00101010101
1C00V00000C01110000001
1C00V00000C01110000001
1C00V00000C01110000001
1C00V00000C01110000001
1C00V00000C01110000001
1C00V00000C01110000001
1C00V00000C01110000001
1C00V00000C01110000001
1C00V00000C01110000001
1C00V00000C00000000001
1C00V00000C01110000001
1C00V00000C01110000001
1C00V00000C01110000001
1111111111111111111111