NO ./Texture/colorstone.xpm
SO ./Texture/redbrick.xpm
WE ./Texture/wood.xpm
EA ./Texture/greystone.xpm

F 100,100,100
C 50,50,50

1111111111111111111111111
1E00000000000000000000001
1111111111111111111111101
1000000000000000000000001
1111111111111111111111111
