NO ./path_to_the_north_texture
SO ./path_to_the_south_texture
WE ./path_to_the_west_texture
EA ./path_to_the_east_texture

F 220,100,0
C 225,30,0



     111111111111111111111111
1111110000000110000000000111
101100000111000110000000111
100100000000000110000000111111111
111111111011000001110000000000001
100000000011000001110111111111111
11110111111111011100000010001
111101111      011101010010011
11000000110101011100000010001
10000000000000N01100000010001
10000000000000001101010010001
1100000111010101111101111000111
11110111 1110101 101111010001
11111111 1111111 111111111111