1111111111111
100C0000000C1
1000011111001
1P0011E000001
1000011111001
1000110000C01
1111111111111